XXXXXXXXXXXXXXXX
X              d
X  XHHX  XHXHX X
X  X  X    H   X
X  XHHX  XHXHX X
X         >    X
X  X   XXX     X
X   X    X     X
X              X
XXXXXXXXSXXXXXXX
