XXXXXXXXXXXXXXXXXXXxXXXXXX
X                        X
X                    XHHHX
A                    H   X
X                    H K X
XXXXXXXXXXXXXXXXXXXXXXXXXX
