     XXwXXXXXXXXXXXXXX
     X       X       X
     X       X       X
XXXXXXXXXXXxXXXXXXX XXXXXX
X     <                  X
X                    XHHHX
X                    H   X
X                    H   X
XXXXXXXXXXXXXXXXXXXXXXXXSX
